Memphis	Jackson
Orlando	Newark
Copenhagen	Constanta
Stamford	Minneapolis
Caen	Dublin
Vienna	Poiters
Stockholm	Dallas
Cleveland	NodeID172
Lyon	Dijon
Toronto	Sofia
Krakow	Charlotte
Monterrey	Greensboro
Jacksonville	Detroit
Herndon	Oslo
SanTTDiego	Genoa
Rotterdam	Murcia
Worcester	Sofia
Florence	SantaTTClara
Logrono	Chicago
Worcester	Bratislava
Dortmund	Oslo
Avila	NodeID150
Bordeaux	Washington
Boston	Bilbao
NodeID144	LosTTAngeles
Granada	Zagreb
SanTTFrancisco	Timisoara
Santander	ElTTPaso
NewTTYork	Zagreb
Toronto	Krakow
Mainz_DASH_Wiesbaden	SanTTDiego
Hamburg	Jackson
Berlin	Logrono
Milwaukee	Rome
Porto	Portland
Minneapolis	KapitanTTAndreevo
NodeID149	Atlanta
Avila	Vigo
Dallas	Nuremberg
Coimbra	Mainz_DASH_Wiesbaden
Frankfurt	Rennes
Coimbra	Bologna
NodeID173	Zaragoza
Philadelphia	Antwerp
Varna	Stamford
Bordeaux	Montreal
Constanta	Lille
Edinburgh	NodeID173
Bratislava	Zurich
Rouen	Balchik
